#######################################
# . . . * . . . . ### . . . . * . . . #
# O ### . ##### . ### . ##### . ### O #
# * . . * . * . * . . * . * . * . . * #
# . ### . # . ########### . # . ### . #
# . . . * # . . . ### . . . # * . . . #
####### . ##### . ### . ##### . #######
####### . # . . * . . * . . # . #######
####### . # . ### - - ### . # . #######
####### . # . #         # . # . #######
- . . . * . * #         # * . * . . . -
####### . # . #         # . # . #######
####### . # . ########### . # . #######
####### . # * . . . . . . * # . #######
####### . # . ########### . # . #######
# . . . * . * . . ### . . * . * . . . #
# O ### . ##### . ### . ##### . ### O #
# . . # * . * . *  @  * . * . * # . . #
### . # . # . ########### . # . # . ###
# . * . . # . . . ### . . . # . . * . #
# . ########### . ### . ########### . #
# . . . . . . . * . . * . . . . . . . #
#######################################